XEXXXXXXXXXXXXX
X N          CX
X XXXXXXXXXXX X
X X         X X
X X XXXXXXX X X
X X X     X X X
X X X XXX X X X
X X X X X X X X
X X X X X XXX X
X X   X       X
X XXXXX XXXXXRX
XP   X B      X
X XXXXXXXXX   X
X        X    X
XXXXXXXXXXX SXX