XEXXXXXXXXXXXXX
X        L   CX
X XXXXXXXXXXX X
X X   R     X X
X X XXXXXXX X X
X X X     X X X
X X X XXX X X X
X X X X X X X X
X X X X X XXX X
X X   X       X
X XXXXX XXXXX X
X       X B   X
X XXXXXXXXX   X
X        X    X
XXXXXXXXXXX SXX